111111111
0111C1111
111P0E111
111111111
111111111
