11111111111111111111111
10000000000000000000001
10P0000000CCC000000C001
10000000000000011111001
10000000011000000000001
100000000M11000000000C1
10000000000C11111111111
100C00000100000000000E1
11111111111111111111111
