1111111111111111
1P000000001000E1
1110111011101111
1C00100010000001
1011111010111111
1000000010000001
1011111010111011
1C00010001000001
1011111010111011
1M00000000000C11
1111111111111111
