1111111111111111
1000C000C0000001
1C00000010000001
1C10000CP1000001
1E1C000010000001
1111111111111111
