1111111111111111
10000000C0000001
1C00000000000001
10000000P0000001
1E0C000000000001
1111111111111111
