1111111
1P000M1
1M00101
1C0M0E1
1111111
