111111
1P0MC1
100001
1C00E1
111111
