11111111111111111111111
1C000010000CC00000001C1
11110000001000001111101
1E00000100000P000000001
11111111000000000000001
1CCCCCC00000000000001C1
11111111111111111111111
