1111111
1P000C1
1000101
1C0M0E1
1111111
